R 848 480
F 34,108,106
C 222,89,219

1 1 1 1 1
1 0 0 0 1
1 0 N 0 1
1 0 0 0 1
1 1 1 1 1
1 1 1 1 1
1 1 1 1 1
